NO ./assets/textures/NO.xpm
SO ./assets/textures/SO.xpm
WE ./assets/textures/WE.xpm
EA ./assets/textures/EA.xpm




 F 220,100,0 
C 255,30,0


1111111111111111111111111        
10000000001100010000000011        
1011000001110010100000001                                   
100100000000000100000000111111111
111111111011000001110000000000001
1000000000110S000011101111111111111111111
1000000000000000000000000011100000010001    
11000000000000000000000000011101010010001    
11000001101010111000000100010000000000001
100000000000000011000000100010000000000001
100000000000000011010100100000000000000001
110000011101010111110111100011100000000001
11110111 11010101 101111010001111111111111  
11111111 1111111 111111111111 
